011111111111
1C0000CE0001
1CP000000001
111111111111
